16 16
7 7 7 7 7 7 7 7 7 7 7 7 7 7 7 7
7 7 7 7 7 7 7 7 7 7 7 7 7 7 7 7
7 7 -1 -1 -1 -1 -1 -1 -1 -1 -1 -1 -1 -1 7 7
7 7 3 3 3 3 3 3 3 3 3 3 3 3 7 7
7 7 3 3 3 3 3 3 3 3 3 3 3 3 7 7
7 7 5 3 3 3 3 3 3 3 3 3 3 6 7 7
7 7 7 5 3 3 3 3 3 3 3 3 6 7 7 7
7 7 7 7 5 3 3 3 3 3 3 6 7 7 7 7
7 7 7 7 7 5 3 3 3 3 6 7 7 7 7 7
7 7 7 7 7 7 5 3 3 6 7 7 7 7 7 7
7 7 7 7 7 7 7 5 6 7 7 7 7 7 7 7
7 7 7 7 7 7 7 7 7 7 7 7 7 7 7 7
7 7 7 7 7 7 7 7 7 7 7 7 7 7 7 7
7 7 7 7 7 7 7 7 7 7 7 7 7 7 7 7
7 7 7 7 7 7 7 7 7 7 7 7 7 7 7 7
7 7 7 7 7 7 7 7 7 7 7 7 7 7 7 7