16 16
-1 7 -1 -1 -1 -1 -1 -1 -1 -1 -1 -1 -1 -1 7 -1
-1 7 -1 -1 -1 -1 -1 -1 -1 -1 -1 -1 -1 -1 7 -1
-1 7 -1 -1 -1 -1 -1 -1 -1 -1 -1 -1 -1 -1 7 -1
-1 -1 3 3 3 3 3 3 3 3 3 3 3 3 -1 -1
-1 -1 3 3 3 3 3 3 3 3 3 3 3 3 -1 -1
-1 -1 5 3 3 3 3 3 3 3 3 3 3 6 -1 -1
-1 -1 -1 5 3 3 3 3 3 3 3 3 6 -1 -1 -1
-1 -1 -1 -1 5 3 3 3 3 3 3 6 -1 -1 -1 -1
-1 -1 -1 -1 -1 5 3 3 3 3 6 -1 -1 -1 -1 -1
-1 -1 -1 -1 -1 -1 5 3 3 6 -1 -1 -1 -1 -1 -1
-1 -1 -1 -1 -1 -1 -1 5 6 -1 -1 -1 -1 -1 -1 -1
-1 -1 -1 -1 -1 -1 -1 -1 -1 -1 -1 -1 -1 -1 -1 -1
-1 -1 -1 -1 -1 -1 -1 -1 -1 -1 -1 -1 -1 -1 -1 -1
-1 -1 -1 -1 -1 -1 -1 -1 -1 -1 -1 -1 -1 -1 -1 -1
-1 -1 -1 -1 -1 -1 -1 -1 -1 -1 -1 -1 -1 -1 -1 -1
-1 -1 -1 -1 -1 -1 -1 -1 -1 -1 -1 -1 -1 -1 -1 -1