10 10
3 7 7 7 7 7 7 7 7 4
5 9 9 9 9 9 9 9 9 9
5 9 9 9 9 9 9 9 9 9
5 9 9 9 9 9 9 9 9 9
5 9 9 9 9 9 9 9 9 9
5 9 9 9 9 9 9 9 9 9
5 9 9 9 9 9 9 9 9 9
5 9 9 9 9 9 9 9 9 9
5 9 9 9 9 9 9 9 9 9
1 9 9 9 9 9 9 9 9 9

